**********
*        *
*   *    *
* S *  E *
*   *    *
*        *
*        *
**********