************************************
*S*  **  ******** * *      *     * *
* *   *             * *        *   *
*   * ***** ** ****** * *******  * *
*** * **    **      * * *     **** *
*   *    *  *******   *   ***    *E*
************************************